11111111111111111111
1C0000C00000C0000001
1000C0000C00000C0001
10111010001110100101
101010100010CC011C01
10101C1C001110011001
10111010001E000110C1
10101011101110100101
1000C00P00C000000001
11111111111111111111