11111111111
10010C01001
1C01C001011
1011CEQ1001
1000C000111
1110P0001C1
11111111111