11111111111
10010C01001
1C01C001011
1011CEF1001
1000000CC01
1110P000111
11111111111