1111111111111
1001000000001
100001P111001
1C0011E000001
1111111111111