11111
1C001
101C1
1C101
101C1
101E1
101C1
10101
10101
10P01
11111