1111111111111
10000PEC00001
1111111111111