11111111111111
1100C100011C01
110C0001001011
111100111C1C01
1111C011101101
1E100C011C1001
10100111101001
1P0C0C00000011
11111111111111