1111111
101CC01
1000001
1P1C0E1
1000111
1CC01C1
1111111