11111111111111111111
1P0000C00000C0000001
11111111111111111101
10C01C11100C00000001
10101000101011C11001
1010011C00101C11C101
1C010111111100000101
110100111111C1110101
1E01C00000C0000000C1
11111111111111111111